10,10,10,10,10,10,10,10,10,10,10,10,10,10,10,10,10,10,10,10,10,10,10,10,10,10,10,10,10,10,10,10
10,6,3,3,3,3,3,3,3,3,3,3,3,3,3,3,3,3,3,3,3,3,3,3,3,3,3,3,3,3,7,10
10,5,0,0,0,0,0,0,0,0,0,0,0,0,0,0,0,0,0,0,0,0,0,0,0,0,0,0,0,0,4,10
10,5,0,26,18,18,18,18,18,18,18,18,18,18,18,18,18,18,18,18,25,0,0,0,0,0,0,1,0,0,4,10
10,5,0,15,27,27,27,27,27,27,27,27,27,27,27,27,27,27,27,27,16,0,0,0,0,0,0,0,0,0,4,10
10,5,0,15,27,27,27,27,27,27,27,27,27,27,27,27,27,27,27,27,16,0,0,0,0,0,0,0,0,0,4,10
10,5,0,15,27,27,21,17,17,17,17,17,17,17,17,17,17,22,27,27,16,0,14,2,2,2,2,2,13,0,4,10
10,5,0,15,27,27,16,0,0,0,0,0,0,0,0,0,0,15,27,27,16,0,4,10,10,10,10,10,5,0,4,10
10,5,1,15,27,27,16,0,0,0,0,0,0,0,1,0,0,15,27,27,16,0,4,10,10,10,10,10,5,0,4,10
10,5,0,15,27,27,16,0,0,0,0,0,0,0,0,0,0,15,27,27,16,0,4,10,10,10,10,10,5,0,4,10
10,5,0,15,27,27,16,0,0,0,0,0,0,0,0,0,0,15,27,27,16,0,4,10,10,10,10,10,5,0,4,10
10,5,0,15,27,27,16,0,0,0,0,0,0,0,0,0,0,15,27,27,16,0,4,10,10,10,10,10,5,0,4,10
10,5,0,15,27,27,16,0,0,0,0,0,0,0,0,0,0,15,27,27,16,0,4,10,10,10,10,10,5,0,4,10
10,5,0,15,27,27,16,0,0,0,0,0,0,0,0,0,0,15,27,27,16,0,4,10,10,10,10,10,5,0,4,10
10,5,0,15,27,27,16,0,0,0,0,0,0,0,0,0,0,15,27,27,16,0,11,7,10,10,10,10,5,0,4,10
10,5,0,15,27,27,16,0,0,0,0,0,0,0,0,0,0,15,27,27,16,0,0,11,3,3,3,3,12,0,4,10
10,5,0,15,27,27,16,0,0,0,0,0,0,0,0,0,0,15,27,27,20,18,18,18,18,18,18,18,18,25,4,10
10,5,0,15,27,27,16,0,0,0,1,0,0,0,0,0,0,15,27,27,27,27,27,27,27,27,27,27,27,16,4,10
10,5,0,15,27,27,16,0,0,0,0,0,0,0,0,0,0,15,27,27,27,27,27,27,27,27,27,27,27,16,4,10
10,5,0,15,27,27,16,0,0,0,0,0,0,0,0,0,0,23,17,17,17,17,17,17,17,17,22,27,27,16,4,10
10,5,0,15,27,27,16,0,0,0,0,0,0,0,0,0,0,0,0,0,0,0,0,0,0,0,15,27,27,16,4,10
10,5,0,15,27,27,16,0,0,0,0,0,0,0,0,0,0,0,0,0,0,0,0,0,0,0,15,27,27,16,4,10
10,5,0,15,27,27,16,0,0,0,0,0,0,0,0,0,0,0,0,0,0,0,0,0,0,0,15,27,27,16,4,10
10,5,0,15,27,27,16,0,0,0,0,0,0,0,0,0,0,0,0,0,0,0,1,0,0,0,15,27,27,16,4,10
10,5,0,15,27,27,16,0,0,0,0,0,0,0,0,0,0,0,0,0,0,0,0,0,0,0,15,27,27,16,4,10
10,5,0,15,27,27,20,18,18,18,18,18,18,18,18,18,18,18,18,18,18,18,18,18,18,18,19,27,27,16,4,10
10,5,0,15,27,27,27,27,27,27,27,27,27,27,27,27,27,27,27,27,27,27,27,27,27,27,27,27,27,16,4,10
10,5,0,15,27,27,27,27,27,27,27,27,27,27,27,27,27,27,27,27,27,27,27,27,27,27,27,27,27,16,4,10
10,5,0,23,17,17,17,17,17,17,17,17,17,17,17,17,17,17,17,17,17,17,17,17,17,17,17,17,17,24,4,10
10,5,0,0,0,0,0,0,0,0,0,0,0,0,0,0,0,0,0,0,0,0,0,0,0,0,0,0,0,0,4,10
10,9,2,2,2,2,2,2,2,2,2,2,2,2,2,2,2,2,2,2,2,2,2,2,2,2,2,2,2,2,8,10
10,10,10,10,10,10,10,10,10,10,10,10,10,10,10,10,10,10,10,10,10,10,10,10,10,10,10,10,10,10,10,10
